111111111111111111111111111111
10P00C000000000000000000000001
100000000000000000001000000001
100000000000000000000000000001
100000000000000000000000000001
100000000000000000000000000001
100000000000000000000000000001
1000000000001000000C0000000001
100000000000000000000000000001
1000000000000000000000000E0001
100000000000000000000000000001
100000000000000000000000000001
100000000000000000000000000001
10000C0000C0000000000000000001
100000000000000000110000000001
100000000000000000110000000001
100000000000000000000000000001
100000000000000000000000000001
100000000000000000000000000001
111111111111111111111111111111