311171111111117111111111171114
200020000000009000000000020002
200020000000009000000000020002
200020000000009000000000020002
200020000000009000000000020002
200020000000009000000000020002
200020000000009000000000020002
200020000000009000000000020002
200020000000009000000000020002
200020000000009000000000020002
200020000000009000000000020002
200020000000009000000000020002
200020000000009000000000020002
200020000000009000000000020002
200020000000009000000000020002
200020000000009000000000020002
200020000000009000000000020002
200020000000009000000000020002
200020000000009000000000020002
511181111111118111111111181116