111111111111111111111111111111
10P000CCCC00000000000000000001
100000000000000000001000000001
100000000000000000000000000001
100000000000000000000000000001
100000000000000000000000000001
100000000000000000000000000001
100000000000100000000000000001
100000000000000000000000000001
1000000000000000000000000E0001
100000000000000000000000000001
100000000000000000000000000001
100000000000000000000000000001
100000000000000000000000000001
100000000000000000110000000001
100000000000000000110000000001
100000000000000000000000000001
100000000000000000000000000001
100000000000000000000000000001
111111111111111111111111111111